# 语法高亮

# 类
ESP32_OTA_WS_Lib	KEYWORD1
OTAManager	KEYWORD1
WiFiManager	KEYWORD1
WebSocketManager	KEYWORD1
WebServerManager	KEYWORD1
SystemMonitor	KEYWORD1
StatusIndicator	KEYWORD1

# 方法
begin	KEYWORD2
handle	KEYWORD2
enableApiMonitoring	KEYWORD2
setRebootInterval	KEYWORD2
broadcastMessage	KEYWORD2
getOTAManager	KEYWORD2
getWiFiManager	KEYWORD2
getWebSocketManager	KEYWORD2
getWebServerManager	KEYWORD2
getSystemMonitor	KEYWORD2
getStatusIndicator	KEYWORD2
connectToWiFi	KEYWORD2
startAPMode	KEYWORD2
scanNetworks	KEYWORD2
saveWiFiCredentials	KEYWORD2
loadWiFiCredentials	KEYWORD2
resetWiFiCredentials	KEYWORD2
isConnected	KEYWORD2
getWiFiStatusString	KEYWORD2
getSSID	KEYWORD2
getRSSI	KEYWORD2
broadcastTXT	KEYWORD2
sendTXT	KEYWORD2
setMode	KEYWORD2
triggerApiActivity	KEYWORD2
setColor	KEYWORD2
handleFirmwareUpdate	KEYWORD2
handleFilesystemUpdate	KEYWORD2
sendUpdateProgress	KEYWORD2

# 常量
LED_BOOT_ANIMATION	LITERAL1
LED_AP_MODE	LITERAL1
LED_CONNECTED	LITERAL1
LED_API_ACTIVE	LITERAL1
LED_OTA_IN_PROGRESS	LITERAL1
FIRMWARE_SUCCESS	LITERAL1
FILESYSTEM_SUCCESS	LITERAL1
LED_ERROR	LITERAL1
ESP32_OTA_WS_LIB_VERSION	LITERAL1 